00000010101101110011
00100000101100100000
00010010000000110010
00000001000000001000
00000010010101010010
00001100010000101011
01100001110000010101
00000010000100001000
01100001110010010011
00010000001100101000
